Version: 2.00
Level:
www.OFTanna.de
Memory2
Bricks:
#.#.###.#.#...
###.#...###...
#.#.##..#.#...
#.#.#...#.#.@@
#.#.###.#.#..@
............@@
@@@.@@@.@.@.@.
@.@.@.@.@.@.@@
@.@.@@@.@@@...
@.@.@@....@...
@@@.@.@.@@@...
..............
..............
...EEEEEEEE...
...E.E...E....
...E.EE..E....
...E.E...E....
...EEE.g.E....
Bonus:
..............
..............
..............
..............
..............
..............
..............
..............
..............
..............
..............
..............
..............
..............
..............
..............
..............
..............
Level:
OFT
3Rows
Bricks:
..............
..............
..z.z.z.z.z.z.
..............
..............
..z.z.z.z.z.z.
..............
..............
..z.z.z.z.z.z.
..............
..............
..............
..............
..............
..............
..............
..............
..............
Bonus:
..............
..............
..2.2.2.2.2.2.
..............
..............
..2.2.2.2.2.2.
..............
..............
..2.+.+.+.+.2.
..............
..............
..............
..............
..............
..............
..............
..............
..............
Level:
OFT
3Rows II
Bricks:
..............
..............
..z.z.z.z.z.z.
..............
..............
.z.z.z.z.z.z..
..............
..............
..z.z.z.z.z.z.
..............
..............
..............
..............
..............
..............
..............
..............
..............
Bonus:
..............
..............
..2.2.2.2.2.2.
..............
..............
.2.2.2.2.2.2..
..............
..............
..2.+.+.+.+.2.
..............
..............
..............
..............
..............
..............
..............
..............
..............
Level:
OFT
4Rows
Bricks:
..............
..............
..z.z.z.z.z.z.
..............
..............
..z.z.z.z.z.z.
..............
..............
..z.z.z.z.z.z.
..............
..............
..z.z.z.z.z.z.
..............
..............
..............
..............
..............
..............
Bonus:
..............
..............
..2.2.2.2.2.2.
..............
..............
..2.2.2.2.2.2.
..............
..............
..2.2.2.2.2.2.
..............
..............
..+.+.+.+.+.2.
..............
..............
..............
..............
..............
..............
Level:
OFT
4Rows II
Bricks:
..............
..............
.z.z.z.z.z.z..
..............
..............
..z.z.z.z.z.z.
..............
..............
.z.z.z.z.z.z..
..............
..............
..z.z.z.z.z.z.
..............
..............
..............
..............
..............
..............
Bonus:
..............
..............
.2.2.2.2.2.2..
..............
..............
..2.2.2.2.2.2.
..............
..............
.2.2.2.2.2.2..
..............
..............
..+.+.+.+.+.2.
..............
..............
..............
..............
..............
..............
Level:
OFT
5Rows
Bricks:
..............
..............
..z.z.z.z.z.z.
..............
..............
..z.z.z.z.z.z.
..............
..............
..z.z.z.z.z.z.
..............
..............
..z.z.z.z.z.z.
..............
..............
..z.z.z.z.z.z.
..............
..............
..............
Bonus:
..............
..............
..2.2.2.2.2.2.
..............
..............
..2.2.2.2.2.2.
..............
..............
..2.2.2.2.2.2.
..............
..............
..2.2.2.2.2.2.
..............
..............
..+.+.+.+.+.+.
..............
..............
..............
Level:
OFT
5Rows II
Bricks:
..............
..............
..z.z.z.z.z.z.
..............
..............
.z.z.z.z.z.z..
..............
..............
..z.z.z.z.z.z.
..............
..............
.z.z.z.z.z.z..
..............
..............
..z.z.z.z.z.z.
..............
..............
..............
Bonus:
..............
..............
..2.2.2.2.2.2.
..............
..............
.2.2.2.2.2.2..
..............
..............
..2.2.2.2.2.2.
..............
..............
.2.2.2.2.2.2..
..............
..............
..+.+.+.+.+.+.
..............
..............
..............
Level:
OFT
END
Bricks:
#.#.###.#.#...
###.#...###...
#.#.##..#.#...
#.#.#...#.#.@@
#.#.###.#.#..@
............@@
@@@.@@@.@.@.@.
@.@.@.@.@.@.@@
@.@.@@@.@@@...
@.@.@@....@...
@@@.@.@.@@@...
..............
..............
.EEE.E..E.EE..
.E...EE.E.E.E.
.EE..EEEE.E.E.
.E...E.EE.E.E.
.EEE.E..E.EE..
Bonus:
..............
..............
..............
..............
..............
..............
..............
..............
..............
..............
..............
..............
..............
..............
..............
..............
..............
..............
